1111111111111111111111111111111111
1000000000000000000C0000CC00000001
1010010100100000101001000000010101
1010010010101010001001000000010101
100000P00000000000000000000CC00001
110000000110000D000000000000D00001
1100D010011000000E000000C000C00001
11000D0001111001000001111100000001
10000D000000000100000C000000000001
10000D000000000100000C000000000001
10000D0C0000000100000C000000000001
10000D000000000100000C000000000001
1111111111111111111111111111111111